,Brand,Resolution,Size ,Selling Price,Original Price,Operating System,Rating,Discount
0,TOSHIBA,Ultra HD LED,55,37999,54990,VIDAA,4.3,16991
1,TCL ,QLED Ultra HD,55,52999,129990,Android,4.4,76991
2,REALME ,HD LED,32,13999,17999,Android,4.3,4000
3,MI ,HD LED,32,14999,19999,Android,4.4,5000
4,REALME ,HD LED,32,12999,21999,Android,4.3,9000
5,ONEPLUS,HD LED,32,15999,19999,Android,4.3,4000
6,ONEPLUS,Full HD LED,43,25999,29999,Android,4.3,4000
7,TCL ,Ultra HD LED,65,57999,119990,Android,4.2,61991
8,MI ,Full HD LED,40,21999,29999,Android,4.3,8000
9,REALME ,Ultra HD LED,43,26999,32999,Android,4.3,6000
10,MI ,Ultra HD LED,43,27999,34999,Android,4.3,7000
11,HISENSE,Ultra HD LED,55,36999,49990,Android,4.4,12991
12,MI ,Ultra HD LED,50,35999,41999,Android,4.3,6000
13,MI ,HD LED,32,15499,19999,Android,4.3,4500
14,MI ,HD LED,32,14999,19999,Android,4.3,5000
15,HISENSE,Ultra HD LED,70,89999,119990,Android,4.4,29991
16,LG ,HD LED,32,17499,21990,Linux,4.4,4491
17,MI ,Full HD LED,43,25999,31999,Android,4.3,6000
18,MI ,Ultra HD LED,55,45999,69999,Android,4.2,24000
19,TOSHIBA,Ultra HD LED,43,27999,39990,VIDAA,4.3,11991
20,MARQ BY FLIPKART,HD LED,32,9999,19999,Unknown,4.3,10000
21,MI ,Ultra HD LED,43,31999,49999,Android,4.2,18000
22,IFFALCON BY TCL,Ultra HD LED,55,32999,70990,Android,4.3,37991
23,TCL ,Ultra HD LED,50,33999,62990,Android,4.4,28991
24,ONEPLUS,Full HD LED,40,22499,27999,Android,4.3,5500
25,COOCAA ,HD LED,32,10999,36990,Android,4.2,25991
26,TOSHIBA,HD LED,32,12499,14990,VIDAA,4.4,2491
27,MI ,Full HD LED,43,24999,34999,Android,4.3,10000
28,SAMSUNG,Ultra HD LED,43,38990,54900,Tizen,4.3,15910
29,MI ,Ultra HD LED,55,42999,49999,Android,4.3,7000
30,LG ,Full HD LED,43,33490,40990,WebOS,4.4,7500
31,INFINIX,Full HD LED,43,20499,24999,Android,4.2,4500
32,MI ,Ultra HD LED,50,41999,59999,Android,4.2,18000
33,INFINIX,HD LED,32,11999,17999,Android,4.2,6000
34,LG ,Ultra HD LED,55,52999,79990,WebOS,4.4,26991
35,VU,Ultra HD LED,55,46999,85000,Android,4.4,38001
36,NOKIA ,Ultra HD LED,43,32999,48999,Android,4.4,16000
37,VU,Ultra HD LED,43,31000,39999,Android,4.4,8999
38,NOKIA ,Ultra HD LED,50,39999,59999,Android,4.4,20000
39,THOMSON,Ultra HD LED,50,32999,40999,Android,4.4,8000
40,THOMSON,HD LED,24,8499,10499,Android,4.1,2000
41,MI ,QLED Ultra HD,55,58999,59999,Android,4.4,1000
42,ONEPLUS,Ultra HD LED,55,49999,59999,Android,4.3,10000
43,VU,Ultra HD LED,50,40999,65000,Android,4.4,24001
44,LG ,Ultra HD LED,43,42990,59990,WebOS,4.5,17000
45,IFFALCON BY TCL,Ultra HD LED,43,24999,47990,Android,4.3,22991
46,NOKIA ,Ultra HD LED,43,31999,45999,Android,4.1,14000
47,THOMSON,Full HD LED,42,20499,27999,Android,4.3,7500
48,THOMSON,Ultra HD LED,55,34999,46999,Android,4.2,12000
49,IFFALCON BY TCL,Full HD LED,43,21999,44990,Android,4.2,22991
50,NOKIA ,Ultra HD LED,55,44999,62999,Android,4.4,18000
51,SONY ,HD LED,32,25490,29900,Linux,4.5,4410
52,THOMSON,Ultra HD LED,50,31999,42999,Android,4.2,11000
53,KODAK ,Ultra HD LED,55,36999,47999,Android,4.4,11000
54,MOTOROLA,Ultra HD LED,43,32999,46999,Android,4.3,14000
55,THOMSON,Full HD LED,40,19499,21499,Android,4.4,2000
56,SAMSUNG,HD LED,32,18490,20900,Tizen,4.3,2410
57,LG ,Ultra HD LED,50,49999,64990,WebOS,4.4,14991
58,IFFALCON BY TCL,Ultra HD LED,55,35999,106990,Android,4.3,70991
59,THOMSON,HD LED,32,11999,14499,Android,4.4,2500
60,MOTOROLA,QLED Ultra HD,50,45999,59999,Android,4.3,14000
61,MOTOROLA,Full HD LED,40,24999,39999,Android,4.4,15000
62,KODAK ,HD LED,32,12999,18499,Android,4.4,5500
63,SAMSUNG,Ultra HD LED,50,51990,71400,Tizen,4.3,19410
64,MOTOROLA,HD LED,32,20999,29999,Android,4.4,9000
65,TCL ,QLED Ultra HD,50,45999,109990,Android,4.4,63991
66,SONY ,Full HD LED,43,43490,44900,Linux,4.5,1410
67,PHILIPS,Ultra HD LED,58,45999,89990,Android,4.2,43991
68,COOCAA ,Ultra HD LED,55,34999,73990,Android,4.3,38991
69,PHILIPS,Ultra HD LED,50,38999,69990,Linux,4.2,30991
70,NOKIA ,QLED Ultra HD,55,54999,79999,Android,4.2,25000
71,SONY ,Full HD LED,49,44999,69900,Android,4.5,24901
72,KODAK ,Full HD LED,40,19499,20999,Android,4.4,1500
73,KODAK ,Full HD LED,42,20499,27999,Android,4.4,7500
74,MOTOROLA,Ultra HD LED,50,39999,54999,Android,4.3,15000
75,ACER,HD LED,32,13999,19990,Android,3.9,5991
76,TCL ,Full HD LED,55,41999,109990,Android,4.3,67991
77,SAMSUNG,HD LED,32,16290,16400,Tizen,4.3,110
78,TCL ,Ultra HD LED,43,29999,51990,Linux,4.4,21991
79,BLAUPUNKT,Full HD LED,42,20999,29999,Android,4.4,9000
80,PHILIPS,Full HD LED,43,29999,44990,Android,4.2,14991
81,NOKIA ,Ultra HD LED,55,39999,59999,Android,4.3,20000
82,HISENSE,Ultra HD LED,55,46999,59990,Android,4.5,12991
83,REALME ,Ultra HD LED,50,39999,42999,Android,4.3,3000
84,SAMSUNG,QLED Ultra HD,55,76999,129900,Tizen,4.5,52901
85,NOKIA ,HD LED,32,16499,19999,Android,4.3,3500
86,PHILIPS,Ultra HD LED,50,42999,79990,Android,4.0,36991
87,MI ,Full HD LED,43,24999,25999,Android,4.4,1000
88,ACER,Full HD LED,42,21999,29990,Android,3.9,7991
89,ACER,Ultra HD LED,50,34999,44990,Android,3.6,9991
90,KODAK ,Ultra HD LED,43,25999,37999,Android,4.4,12000
91,NOKIA ,Ultra HD LED,50,35999,54999,Android,4.3,19000
92,COOCAA ,Full HD LED,42,18999,48990,Android,4.2,29991
93,BLAUPUNKT,Ultra HD LED,50,34499,47999,Android,4.7,13500
94,SAMSUNG,Ultra HD LED,55,55990,76900,Tizen,4.3,20910
95,IFFALCON BY TCL,QLED Ultra HD,55,44999,126990,Android,4.3,81991
96,THOMSON,Ultra HD LED,65,53999,70499,Android,4.4,16500
97,SAMSUNG,Full HD LED,32,20880,24275,Tizen,4.2,3395
98,IFFALCON BY TCL,Full HD LED,40,19999,36990,Android,4.3,16991
99,BLAUPUNKT,Ultra HD LED,43,28999,41999,Android,4.7,13000
100,THOMSON,Ultra HD LED,43,22999,29999,Android,4.3,7000
101,ADSUN,HD LED,32,8699,16999,Android,3.8,8300
102,LG ,Ultra HD LED,55,57999,89990,WebOS,4.5,31991
103,SONY ,Ultra HD LED,43,44999,66900,Linux,4.5,21901
104,SAMSUNG,QLED Ultra HD,50,84999,119900,Tizen,4.8,34901
105,TCL ,Ultra HD LED,55,39999,75990,Android,4.4,35991
106,ACER,Ultra HD LED,58,38999,59990,Android,4.0,20991
107,THOMSON,Ultra HD LED,43,27999,37999,Android,4.4,10000
108,SAMSUNG,QLED Ultra HD,50,68999,112900,Tizen,4.5,43901
109,VU,Ultra HD LED,65,56999,75000,Android,4.4,18001
110,TCL ,HD LED,32,16499,29990,Android,4.2,13491
111,HISENSE,Ultra HD LED,43,29990,36990,Android,4.3,7000
112,KODAK ,Ultra HD LED,55,34499,39990,Android,4.3,5491
113,SONY ,Full HD LED,43,44900,44900,Linux,4.6,0
114,BLAUPUNKT,Ultra HD LED,55,39999,55999,Android,4.7,16000
115,THOMSON,HD LED,32,11999,14990,Android,4.1,2991
116,HISENSE,Ultra HD LED,43,30999,36990,Android,4.4,5991
117,SAMSUNG,Full HD LED,43,32999,53900,Tizen,4.4,20901
118,SAMSUNG,Full HD LED,43,36580,39900,Tizen,4.3,3320
119,KODAK ,HD LED,24,8499,10499,Android,4.0,2000
120,THOMSON,Ultra HD LED,55,34999,46999,Android,4.3,12000
121,SONY ,Ultra HD LED,43,56720,72900,Linux,4.8,16180
122,T-SERIES,HD LED,24,9990,12990,Android,4.237685459940661,3000
123,MOTOROLA,HD LED,32,17999,21799,Android,4.3,3800
124,PANASONIC,Ultra HD LED,50,37999,42990,Android,4.2,4991
125,MOTOROLA,QLED Ultra HD,55,55999,63999,Android,4.3,8000
126,TCL ,Full HD LED,65,63999,159990,Android,4.3,95991
127,COOCAA ,Ultra HD LED,43,23999,54990,Android,4.3,30991
128,LG ,Ultra HD LED,55,65999,109990,WebOS,4.5,43991
129,COOCAA ,Ultra HD LED,50,31499,64990,Android,4.3,33491
130,TCL ,Full HD LED,43,27190,47990,Android,4.3,20800
131,VU,Ultra HD LED,43,30999,36000,Android,4.3,5001
132,TOSHIBA,Full HD LED,43,22499,26990,VIDAA,4.4,4491
133,HISENSE,Ultra HD LED,58,41999,50990,Android,4.4,8991
134,MOTOROLA,Ultra HD LED,65,56999,115399,Android,4.3,58400
135,LG ,HD LED,32,24057,29990,WebOS,4.3,5933
136,SAMSUNG,QLED Ultra HD,50,73990,119900,Tizen,4.3,45910
137,NOKIA ,Full HD LED,43,26999,39999,Android,4.2,13000
138,MICROMAX,HD LED,32,13299,19900,Android,4.4,6601
139,KODAK ,Ultra HD LED,50,32999,42999,Android,4.4,10000
140,MICROMAX,HD LED,39,18999,24990,Android,3.5,5991
141,KODAK ,Ultra HD LED,50,30999,33999,Android,4.3,3000
142,NOKIA ,Ultra HD LED,55,44999,59999,Android,4.1,15000
143,IFFALCON BY TCL,Ultra HD LED,65,53999,106990,Android,4.3,52991
144,PHILIPS,Ultra HD LED,58,41999,119990,Android,4.2,77991
145,SANSUI ,Ultra HD LED,50,36990,45190,Android,4.5,8200
146,SAMSUNG,QLED Ultra HD,43,59990,94900,Tizen,4.7,34910
147,LG ,HD LED,32,19890,27990,Linux,4.3,8100
148,ONEPLUS,Ultra HD LED,55,52999,59999,Android,4.3,7000
149,MOTOROLA,Ultra HD LED,43,35999,49999,Android,4.4,14000
150,SONY ,Full HD LED,43,46799,52900,Android,4.7,6101
151,TCL ,Full HD LED,50,34999,89990,Android,4.3,54991
152,SAMSUNG,Ultra HD LED,43,41900,49990,Tizen,4.237685459940661,8090
153,PANASONIC,Ultra HD LED,55,46999,109900,Linux,4.2,62901
154,LG ,Ultra HD LED,43,41349,57990,WebOS,4.237685459940661,16641
155,SONY ,Ultra HD LED,43,67990,74900,Linux,4.7,6910
156,SAMSUNG,HD LED,32,21600,22900,Tizen,4.5,1300
157,SAMSUNG,QLED Ultra HD,65,121990,222900,Tizen,4.3,100910
158,MOTOROLA,Ultra HD LED,65,66999,79999,Android,4.4,13000
159,LG ,Ultra HD LED,65,83599,119990,WebOS,4.4,36391
160,SAMSUNG,QLED Ultra HD,55,128999,169900,Tizen,4.6,40901
161,SONY ,Ultra HD LED,49,75099,89900,Android,4.4,14801
162,SONY ,Ultra HD LED,55,73999,99990,Linux,4.5,25991
163,CROMA ,HD LED,32,10990,20000,Android,4.8,9010
164,SAMSUNG,Ultra HD LED,50,57989,73900,Tizen,4.7,15911
165,LG ,Ultra HD LED,65,129999,229900,WebOS,5.0,99901
166,SAMSUNG,QLED Ultra HD,55,84990,134900,Tizen,4.7,49910
167,SAMSUNG,Ultra HD LED,43,45400,56900,Linux,4.3,11500
168,CROMA ,HD LED,24,7990,15000,Android,4.237685459940661,7010
169,LG ,Ultra HD LED,55,137490,299990,WebOS,4.237685459940661,162500
170,SAMSUNG,HD LED,32,29900,29900,Tizen,3.8,0
171,TCL ,HD LED,32,14339,22990,Android,4.3,8651
172,LG ,Ultra HD LED,48,89999,169990,WebOS,2.7,79991
173,TCL ,Ultra HD LED,65,146999,299990,Android,4.237685459940661,152991
174,LG ,Ultra HD LED,43,54990,54990,WebOS,4.4,0
175,LG ,Ultra HD LED,55,64999,93990,WebOS,4.3,28991
176,LG ,HD LED,32,28401,30990,WebOS,4.4,2589
177,SANSUI ,Full HD LED,43,27490,33990,Android,4.1,6500
178,LG ,Ultra HD LED,43,43599,59990,WebOS,4.237685459940661,16391
179,SAMSUNG,Ultra HD LED,55,59990,88900,Tizen,4.237685459940661,28910
180,LG ,Ultra HD LED,55,76197,129990,WebOS,4.8,53793
181,REALME ,Full HD LED,32,17999,23999,Android,4.2,6000
182,MICROMAX,Full HD LED,43,22999,26990,Android,3.9,3991
183,SAMSUNG,QLED Ultra HD,55,159500,244900,Tizen,4.4,85400
184,MICROMAX,Full HD LED,43,23990,33000,Android,4.3,9010
185,LG ,Ultra HD LED,43,47499,75343,WebOS,4.5,27844
186,LG ,Ultra HD LED,43,46969,64990,WebOS,4.237685459940661,18021
187,TCL ,Full HD LED,75,144790,259990,Android,4.3,115200
188,LG ,HD LED,32,22200,25999,WebOS,4.3,3799
189,CANDES ,HD LED,24,9999,17990,Android,4.1,7991
190,SAMSUNG,Ultra HD LED,50,55790,69900,Tizen,4.237685459940661,14110
191,SAMSUNG,QLED Ultra HD,55,89390,134900,Tizen,4.237685459940661,45510
192,LG ,Ultra HD LED,43,46590,59990,WebOS,4.5,13400
193,LG ,Full HD LED,55,103990,103990,WebOS,4.2,0
194,SAMSUNG,Ultra HD LED,65,85990,116900,Tizen,4.3,30910
195,SAMSUNG,QLED Ultra HD,65,318700,399900,Tizen,4.237685459940661,81200
196,SAMSUNG,Ultra HD LED,43,44870,54900,Tizen,4.237685459940661,10030
197,SAMSUNG,Ultra HD LED,43,38999,48900,Tizen,4.3,9901
198,MI ,HD LED,32,14999,14999,Android,4.4,0
199,LG ,Ultra HD LED,55,57200,84990,WebOS,4.237685459940661,27790
200,LG ,Ultra HD LED,65,139999,254990,WebOS,4.237685459940661,114991
201,DYANORA,Full HD LED,42,18499,32999,Android,4.237685459940661,14500
202,SONY ,Ultra HD LED,65,169900,239900,Linux,4.237685459940661,70000
203,IFFALCON BY TCL,QLED Ultra HD,65,84999,229990,Android,4.3,144991
204,SONY ,Ultra HD LED,55,102290,139900,Android,4.237685459940661,37610
205,DYANORA,HD LED,32,10999,15999,Android,4.3,5000
206,LG ,Ultra HD LED,65,199999,349990,WebOS,4.4,149991
207,LG ,Ultra HD LED,55,99999,166990,WebOS,4.237685459940661,66991
208,LG ,Ultra HD LED,55,155879,226990,WebOS,4.237685459940661,71111
209,LG ,Ultra HD LED,65,279990,399990,WebOS,4.237685459940661,120000
210,SAMSUNG,Ultra HD LED,55,64299,86900,Tizen,4.6,22601
211,SONY ,Ultra HD LED,75,199491,299900,Linux,4.7,100409
212,SAMSUNG,QLED Ultra HD,65,224999,279900,Tizen,5.0,54901
213,SAMSUNG,Ultra HD LED,55,104900,104900,Tizen,4.4,0
215,HISENSE,HD LED,32,18490,24990,Android,4.237685459940661,6500
216,LG ,Full HD LED,43,36499,41990,WebOS,4.4,5491
217,SAMSUNG,QLED Ultra HD,55,144990,199990,Tizen,4.237685459940661,55000
218,LG ,Ultra HD LED,55,128100,209990,WebOS,4.237685459940661,81890
219,TCL ,Ultra HD LED,55,55499,89900,Android,4.3,34401
220,MICROMAX,Ultra HD LED,49,42490,59990,Android,4.2,17500
221,LG ,Ultra HD LED,55,63990,91990,WebOS,4.7,28000
222,SAMSUNG,QLED Ultra HD,55,163738,211900,Tizen,4.237685459940661,48162
223,BLAUPUNKT,Ultra HD LED,65,55999,75999,Android,4.237685459940661,20000
224,IFFALCON BY TCL,Ultra HD LED,55,36999,59990,Android,4.3,22991
225,SONY ,Ultra HD LED,65,113999,179900,Android,4.4,65901
226,HAIER ,Full HD LED,42,28240,43990,Android,5.0,15750
227,SAMSUNG,Ultra HD LED,65,295900,295900,Tizen,4.237685459940661,0
228,SONY ,Ultra HD LED,65,469999,529900,Android,5.0,59901
229,PANASONIC,Ultra HD LED,55,62738,82990,Linux,4.237685459940661,20252
230,SONY ,Ultra HD LED,75,259999,499900,Android,3.7,239901
231,LG ,Ultra HD LED,65,249999,409990,WebOS,4.8,159991
232,TOSHIBA,Ultra HD LED,50,33999,46990,VIDAA,4.3,12991
233,LG ,Full HD LED,49,77990,77990,WebOS,4.8,0
234,TOSHIBA,HD LED,32,17499,18990,VIDAA,4.3,1491
235,IFFALCON BY TCL,Ultra HD LED,75,149999,239999,Android,4.2,90000
236,PANASONIC,Full HD LED,32,22990,24990,Android,4.2,2000
237,LG ,Ultra HD LED,65,93999,129990,WebOS,4.5,35991
238,SAMSUNG,Ultra HD LED,50,53200,64990,Tizen,4.237685459940661,11790
239,T-SERIES,HD LED,32,12499,14990,Linux,3.7,2491
240,SAMSUNG,QLED Ultra HD,65,148990,259900,Tizen,4.237685459940661,110910
241,SAMSUNG,Ultra HD LED,43,49990,62900,Tizen,4.237685459940661,12910
242,ONIDA,Full HD LED,40,17999,29990,Android,4.1,11991
243,LG ,Ultra HD LED,65,262999,364990,WebOS,4.237685459940661,101991
244,LG ,Ultra HD LED,55,149999,229990,WebOS,4.3,79991
245,LG ,Ultra HD LED,65,224999,379990,WebOS,5.0,154991
246,HAIER ,Ultra HD LED,43,34999,43990,Android,4.1,8991
247,SONY ,HD LED,32,26374,29800,Android,4.4,3426
248,SONY ,Full HD LED,50,60291,64900,Linux,4.5,4609
249,SANSUI ,Ultra HD LED,55,119990,119990,Android,4.3,0
250,TCL ,Ultra HD LED,55,47499,79990,Android,3.9,32491
251,VU,Ultra HD LED,55,41999,58000,Android,4.4,16001
252,RGL ,HD LED,24,9990,12990,HomeOS,4.0,3000
253,SAMSUNG,Ultra HD LED,65,294900,294900,Tizen,4.7,0
254,LG ,Ultra HD LED,70,94990,169990,WebOS,4.237685459940661,75000
255,MI ,HD LED,32,15999,15999,Android,4.4,0
256,KODAK ,HD LED,32,11499,20990,Android,4.3,9491
257,SAMSUNG,Full HD LED,43,38990,56945,Tizen,4.237685459940661,17955
258,SONY ,Ultra HD LED,65,259999,449900,Android,4.3,189901
259,SAMSUNG,Ultra HD LED,65,159500,234900,Tizen,4.6,75400
260,LG ,Ultra HD LED,65,164999,264990,WebOS,4.7,99991
261,SONY ,Ultra HD LED,65,149999,244900,Android,4.7,94901
262,SAMSUNG,QLED Ultra HD,49,74990,129900,Tizen,4.7,54910
263,PHILIPS,Full HD LED,43,28999,35990,Linux,4.1,6991
264,ONIDA,Ultra HD LED,58,53199,79990,Android,4.2,26791
265,SAMSUNG,Ultra HD LED,75,169990,254900,Tizen,4.237685459940661,84910
266,SAMSUNG,QLED Ultra HD,55,84999,133900,Tizen,4.6,48901
267,LG ,Ultra HD LED,55,124999,177990,WebOS,4.4,52991
268,LG ,Ultra HD LED,75,385099,549990,WebOS,4.237685459940661,164891
269,CANDES ,HD LED,32,11299,22690,Android,3.9,11391
270,SAMSUNG,Ultra HD LED,49,179900,179900,Tizen,4.3,0
271,SAMSUNG,Full HD LED,43,62900,62900,Tizen,3.9,0
272,SONY ,Ultra HD LED,55,80799,94900,Linux,4.6,14101
273,SONY ,Ultra HD LED,49,64599,76900,Android,4.6,12301
274,DYANORA,HD LED,32,12499,18999,Android,4.237685459940661,6500
275,MOTOROLA,Ultra HD LED,43,30999,46050,Android,4.3,15051
276,SAMSUNG,QLED Ultra HD,65,470900,470900,Tizen,4.237685459940661,0
277,SONY ,Ultra HD LED,55,129990,155990,Linux,4.237685459940661,26000
278,SAMSUNG,Ultra HD LED,55,61890,79400,Tizen,4.237685459940661,17510
279,SAMSUNG,QLED Ultra HD,65,199990,284990,Tizen,4.237685459940661,85000
280,SAMSUNG,Ultra HD LED,55,204900,204900,Tizen,3.0,0
281,TCL ,Full HD LED,40,26990,39990,Android,4.2,13000
282,LG ,Ultra HD LED,55,64990,102990,WebOS,4.3,38000
283,SAMSUNG,QLED Ultra HD,55,314900,314900,Tizen,4.237685459940661,0
284,SANSUI ,Ultra HD LED,55,69200,69200,Android,3.7,0
285,LLOYD ,Ultra HD LED,65,74999,153990,Linux,4.8,78991
286,SONY ,Ultra HD LED,55,109999,164900,Android,3.6,54901
287,THOMSON,HD LED,32,16999,16999,Android,4.1,0
288,LG ,Ultra HD LED,55,61999,94990,WebOS,4.237685459940661,32991
289,PHILIPS,HD LED,32,18999,20990,Android,4.1,1991
290,SAMSUNG,Ultra HD LED,49,64499,99900,Tizen,4.5,35401
291,LG ,Ultra HD LED,55,81999,149990,WebOS,4.8,67991
292,PANASONIC,HD LED,32,28399,28400,Android,4.2,1
293,LG ,Ultra HD LED,65,199999,349990,WebOS,4.237685459940661,149991
294,SAMSUNG,Ultra HD LED,65,89990,124990,Tizen,4.237685459940661,35000
295,LUMX ,Full HD LED,43,21990,46900,Android,4.237685459940661,24910
296,SAMSUNG,QLED Ultra HD,43,59700,82400,Tizen,4.237685459940661,22700
297,LG ,Ultra HD LED,65,269999,339990,WebOS,4.237685459940661,69991
298,SAMSUNG,Ultra HD LED,75,239999,394900,Tizen,4.237685459940661,154901
299,SAMSUNG,Ultra HD LED,55,241900,241900,Tizen,3.9,0
300,SAMSUNG,Ultra HD LED,65,122299,209900,Tizen,4.7,87601
301,SONY ,Ultra HD LED,55,164999,329900,Android,4.7,164901
302,LG ,Full HD LED,49,74990,74990,WebOS,4.5,0
303,SONY ,Ultra HD LED,65,179999,224900,Android,4.9,44901
304,SAMSUNG,QLED Ultra HD,65,258999,419900,Tizen,4.237685459940661,160901
305,SONY ,Ultra HD LED,65,112100,179990,Android,4.7,67890
306,SONY ,HD LED,32,26990,29900,Linux,4.4,2910
307,SANSUI ,HD LED,32,21499,22990,Android,4.237685459940661,1491
308,LG ,Full HD LED,43,38899,45900,WebOS,3.7,7001
309,SAMSUNG,Ultra HD LED,55,62980,80000,Tizen,4.237685459940661,17020
310,LG ,Ultra HD LED,65,89978,149990,WebOS,4.237685459940661,60012
311,PANASONIC,Ultra HD LED,55,50499,65490,Linux,4.237685459940661,14991
312,TCL ,Ultra HD LED,65,86091,109990,Android,4.3,23899
313,SAMSUNG,Full HD LED,55,118900,118900,Tizen,4.0,0
314,SONY ,Ultra HD LED,50,81990,99900,Android,4.7,17910
315,SAMSUNG,Ultra HD LED,49,129900,129900,Tizen,4.4,0
316,LG ,Full HD LED,49,64900,64900,WebOS,4.2,0
317,CROMA ,Ultra HD LED,55,50990,75000,FireTV OS,4.237685459940661,24010
318,SAMSUNG,HD LED,32,18490,22500,Tizen,4.0,4010
319,LG ,Ultra HD LED,55,114999,189990,WebOS,2.7,74991
320,CANDES ,Full HD LED,40,15999,29990,Android,4.1,13991
321,SAMSUNG,Ultra HD LED,65,89990,115990,Tizen,4.237685459940661,26000
322,PHILIPS,Ultra HD LED,50,37999,105990,Android,4.2,67991
323,IFFALCON BY TCL,Ultra HD LED,55,43999,73990,Android,4.4,29991
324,SAMSUNG,Ultra HD LED,50,125900,125900,Tizen,4.3,0
325,MICROMAX,HD LED,32,15990,22990,Android,4.2,7000
326,LG ,Ultra HD LED,49,80990,80990,WebOS,4.5,0
327,LG ,Ultra HD LED,65,149999,219990,WebOS,5.0,69991
328,LG ,Full HD LED,49,67990,67990,WebOS,4.5,0
329,SAMSUNG,Ultra HD LED,50,51990,67069,Tizen,4.0,15079
330,SAMSUNG,QLED Ultra HD,55,274900,274900,Tizen,5.0,0
331,LG ,Ultra HD LED,55,324990,324990,WebOS,4.6,0
332,ONIX ,Ultra HD LED,50,49990,59990,Android,4.237685459940661,10000
333,SAMSUNG,QLED Ultra HD,50,69990,99990,Tizen,4.0,30000
334,SAMSUNG,Full HD LED,43,45785,45900,Tizen,4.237685459940661,115
335,SAMSUNG,QLED Ultra HD,55,121999,143900,Tizen,4.3,21901
336,CROMA ,HD LED,32,14990,25000,FireTV OS,4.237685459940661,10010
337,ACER,HD LED,32,14999,22990,Android,3.9,7991
338,SAMSUNG,Full HD LED,48,49990,77900,Tizen,3.7,27910
339,SAMSUNG,Ultra HD LED,75,159990,266900,Tizen,4.237685459940661,106910
340,IFFALCON BY TCL,QLED Ultra HD,65,156990,156990,Android,4.237685459940661,0
341,SAMSUNG,Ultra HD LED,43,44990,78000,Tizen,4.237685459940661,33010
342,SAMSUNG,QLED Ultra HD,65,162900,209900,Tizen,4.237685459940661,47000
343,SAMSUNG,Ultra HD LED,55,145900,145900,Tizen,4.8,0
344,LG ,Ultra HD LED,65,109999,209990,WebOS,5.0,99991
345,DYANORA,Ultra HD LED,50,27599,40999,Android,4.237685459940661,13400
346,IMPEX ,HD LED,32,28690,28690,HomeOS,4.237685459940661,0
347,SAMSUNG,Ultra HD LED,43,89850,89850,Tizen,4.1,0
348,LG ,Ultra HD LED,65,349999,499990,WebOS,4.237685459940661,149991
349,SAMSUNG,QLED Ultra HD,55,139990,209900,Tizen,4.237685459940661,69910
350,SONY ,Ultra HD LED,65,142499,199900,Android,4.237685459940661,57401
351,SAMSUNG,Ultra HD LED,65,167199,269900,Tizen,4.237685459940661,102701
352,IMPEX ,HD LED,39,29079,39990,HomeOS,4.2,10911
353,LG ,Ultra HD LED,49,120989,120990,WebOS,4.4,1
354,CROMA ,Full HD LED,43,31990,40000,Android,4.237685459940661,8010
355,SONY ,Ultra HD LED,43,63990,72900,Linux,4.4,8910
356,SAMSUNG,QLED Ultra HD,55,105990,162900,Tizen,4.237685459940661,56910
357,IMPEX ,HD LED,40,28399,45990,HomeOS,4.237685459940661,17591
358,VU,QLED Ultra HD,85,259999,350000,Android,4.4,90001
359,SAMSUNG,Ultra HD LED,55,154900,154900,Tizen,5.0,0
361,SONY ,Ultra HD LED,50,72715,92900,Android,4.237685459940661,20185
362,SAMSUNG,Full HD LED,49,65999,82500,Tizen,4.3,16501
363,SAMSUNG,QLED Ultra HD,65,144900,229990,Tizen,4.237685459940661,85090
364,LG ,Ultra HD LED,65,229000,359990,WebOS,4.237685459940661,130990
365,TCL ,HD LED,32,15000,29990,Android,4.2,14990
366,SANSUI ,Ultra HD LED,43,29490,32290,Android,4.1,2800
367,SAMSUNG,QLED Ultra HD,65,122290,222900,Tizen,4.5,100610
368,SAMSUNG,Ultra HD LED,55,284900,284900,Tizen,3.6,0
369,SAMSUNG,Ultra HD LED,65,103990,135900,Tizen,4.237685459940661,31910
370,LG ,Ultra HD LED,55,97990,139989,WebOS,4.237685459940661,41999
371,SAMSUNG,HD LED,24,15200,15200,Tizen,4.2,0
372,VU,Ultra HD LED,55,46899,75000,Android,4.4,28101
374,HISENSE,HD LED,32,17499,17990,Android,4.2,491
375,ONIDA,HD LED,39,23990,31990,Android,3.9,8000
376,SAMSUNG,Full HD LED,49,45700,66900,Tizen,4.2,21200
378,SAMSUNG,Ultra HD LED,49,146900,146900,Tizen,4.5,0
379,LG ,Full HD LED,49,40000,65900,Linux,4.2,25900
380,BPL ,Ultra HD LED,55,50490,73000,Android,4.237685459940661,22510
381,DYANORA,HD LED,24,7999,10999,Android,4.3,3000
382,SAMSUNG,HD LED,32,19599,25900,Tizen,4.3,6301
383,SAMSUNG,QLED Ultra HD,65,219990,257900,Tizen,4.237685459940661,37910
384,SAMSUNG,QLED Ultra HD,55,89990,163900,Tizen,4.7,73910
385,CROMA ,Ultra HD LED,43,35990,50000,FireTV OS,5.0,14010
386,CLOUDWALKER,Ultra HD LED,65,59999,94990,Android,4.0,34991
387,TCL ,QLED Ultra HD,55,47990,99990,Android,4.237685459940661,52000
388,MARQ BY FLIPKART,Ultra HD LED,65,64999,94499,Android,4.4,29500
389,LG ,Ultra HD LED,75,189999,284990,WebOS,3.0,94991
390,PANASONIC,Ultra HD LED,65,86890,93500,Linux,4.237685459940661,6610
391,SAMSUNG,QLED Ultra HD,50,69744,99900,Tizen,4.237685459940661,30156
392,NOKIA ,Ultra HD LED,65,57999,79999,Android,4.3,22000
393,THOMSON,HD LED,32,13499,15499,Android,4.4,2000
394,SAMSUNG,Full HD LED,43,36990,38900,Tizen,4.1,1910
395,THOMSON,Full HD LED,43,20499,25999,Android,4.4,5500
396,BLAUPUNKT,HD LED,32,12999,19499,Android,4.4,6500
397,LLOYD ,HD LED,32,20990,25900,Linux,4.8,4910
398,OXYGEN ,Ultra HD LED,50,35990,52990,Android,4.237685459940661,17000
399,PANASONIC,Ultra HD LED,65,90314,119990,Linux,4.237685459940661,29676
400,CROMA ,HD LED,32,20990,30000,Android,3.7,9010
401,CROMA ,Full HD LED,43,30990,40000,FireTV OS,4.237685459940661,9010
402,MICROMAX,HD LED,32,23989,23990,Android,4.2,1
403,SAMSUNG,HD LED,32,23000,25900,Tizen,4.4,2900
404,POWER GUARD,HD LED,32,15499,24990,Android,4.237685459940661,9491
405,AKAI ,Ultra HD LED,65,72940,124990,Android,4.237685459940661,52050
406,VG ,Ultra HD LED,43,24990,51000,Android,4.237685459940661,26010
407,CROMA ,HD LED,32,19490,25000,FireTV OS,4.237685459940661,5510
408,INFINIX,Full HD LED,40,18999,26990,Android,4.2,7991
409,ADSUN,HD LED,24,6799,10999,Android,3.8,4200
410,TCL ,Ultra HD LED,65,68990,127445,Android,4.5,58455
411,KODAK ,Full HD LED,43,22499,24999,Android,4.4,2500
412,MOTOROLA,Full HD LED,43,27999,35500,Android,4.3,7501
413,ONIX ,Full HD LED,43,29990,38790,Android,4.9,8800
414,SUN KING,HD LED,32,24999,49998,Unknown,4.237685459940661,24999
415,LG ,Ultra HD LED,48,105990,110690,WebOS,4.237685459940661,4700
416,LG ,Ultra HD LED,65,174999,209990,WebOS,4.237685459940661,34991
417,TCL ,HD LED,32,15499,22990,Android,4.2,7491
418,ONIX ,Full HD LED,43,39000,46990,Android,4.237685459940661,7990
419,TCL ,Ultra HD LED,55,104999,239990,Android,4.237685459940661,134991
420,SAMSUNG,Ultra HD LED,55,149900,149900,Tizen,4.237685459940661,0
421,HAIER ,Full HD LED,43,30490,38990,Android,4.3,8500
422,VG ,HD LED,39,18990,26000,Android,4.237685459940661,7010
423,SAMSUNG,Ultra HD LED,49,129900,129900,Tizen,3.4,0
424,LG ,Full HD LED,49,77900,77900,WebOS,4.1,0
425,SAMSUNG,Ultra HD LED,49,136500,136500,Tizen,4.4,0
426,KODAK ,HD LED,32,11499,15999,Android,4.1,4500
427,ONIX ,HD LED,32,15990,16990,Android,4.237685459940661,1000
428,LG ,Ultra HD LED,48,103990,199990,WebOS,4.237685459940661,96000
429,SAMSUNG,QLED Ultra HD,49,84990,110900,Tizen,4.237685459940661,25910
430,SANSUI ,Ultra HD LED,43,34999,34999,Android,4.3,0
431,PANASONIC,HD LED,32,21078,25490,Android,4.237685459940661,4412
432,SANSUI ,HD LED,32,16990,20990,Linux,4.1,4000
433,SAMSUNG,Full HD LED,43,48900,48900,Tizen,4.2,0
435,SAMSUNG,Ultra HD LED,65,94990,145900,Tizen,2.8,50910
436,COMPAQ ,QLED Ultra HD,65,99999,229990,Android,4.4,129991
437,PANASONIC,Ultra HD LED,65,103353,129990,Linux,4.237685459940661,26637
438,HUIDI ,HD LED,32,10999,18599,Android,4.0,7600
439,IMPEX ,HD LED,32,29790,29790,HomeOS,4.237685459940661,0
440,HUIDI ,HD LED,24,7499,10999,Android,4.0,3500
441,LG ,HD LED,32,18450,19990,Linux,4.2,1540
442,ADSUN,HD LED,32,9799,21999,Android,3.8,12200
443,MICROMAX,HD LED,32,13999,24990,Android,3.7,10991
444,CROMA ,HD LED,32,15990,20000,Android,4.237685459940661,4010
445,SANSUI ,HD LED,32,15290,20990,Linux,4.237685459940661,5700
446,TCL ,QLED Ultra HD,65,89999,189990,Android,4.4,99991
447,HUIDI ,HD LED,40,16999,27999,Android,4.0,11000
448,COOCAA ,HD LED,32,12499,25990,Android,4.2,13491
449,TCL ,QLED Ultra HD,55,59999,189990,Android,3.9,129991
450,SANSUI ,Full HD LED,40,24990,29290,Linux,3.7,4300
451,INTEX ,HD LED,39,19800,33330,Android,4.2,13530
452,SAMSUNG,QLED Ultra HD,49,64990,101900,Tizen,4.8,36910
453,SAMSUNG,QLED Ultra HD,55,105990,189990,Tizen,4.237685459940661,84000
454,LUMX ,HD LED,32,11990,26900,Android,3.7,14910
455,CANDES ,Full HD LED,43,20999,38490,Android,4.1,17491
456,HAIER ,Ultra HD LED,65,69590,106990,Android,4.237685459940661,37400
457,HAIER ,Ultra HD LED,65,99999,149990,Android,4.237685459940661,49991
458,LLOYD ,Full HD LED,39,22990,32990,Linux,4.1,10000
459,SAMSUNG,HD LED,32,17999,23890,Tizen,4.2,5891
460,DETEL ,Ultra HD LED,55,35199,89000,Android,4.0,53801
461,BPL ,Ultra HD LED,50,42490,60000,Android,4.237685459940661,17510
462,LG ,Ultra HD LED,49,59999,110990,WebOS,4.3,50991
463,LG ,Ultra HD LED,65,99990,169990,WebOS,4.5,70000
464,HAIER ,HD LED,32,18590,31090,Android,4.237685459940661,12500
465,JVC,Ultra HD LED,55,37999,59999,Android,4.1,22000
466,PANASONIC,Ultra HD LED,43,35999,84900,Linux,4.4,48901
467,HAIER ,HD LED,32,18290,22990,Android,4.0,4700
468,T-SERIES,HD LED,40,19999,28990,Android,4.237685459940661,8991
469,T-SERIES,HD LED,32,15990,16990,Linux,4.237685459940661,1000
470,LLOYD ,HD LED,32,18689,26957,Linux,4.237685459940661,8268
471,LLOYD ,Full HD LED,43,34990,48990,Linux,4.237685459940661,14000
472,BPL ,HD LED,32,16499,27000,Android,3.7,10501
473,LG ,Ultra HD LED,49,58999,90990,WebOS,4.3,31991
474,BPL ,HD LED,43,28990,35999,Android,4.237685459940661,7009
475,SAMSUNG,HD LED,32,26900,26900,Tizen,4.0,0
476,SONY ,Ultra HD LED,65,191492,364900,Android,3.8,173408
477,LLOYD ,Ultra HD LED,50,44999,84990,Linux,4.3,39991
478,LG ,Ultra HD LED,65,189999,299990,WebOS,2.7,109991
479,CANDES ,HD LED,24,8699,15990,Android,3.9,7291
480,SAMSUNG,Ultra HD LED,50,52890,70900,Tizen,4.0,18010
481,IMPEX ,Full HD LED,43,27039,32039,HomeOS,4.0,5000
482,HAIER ,Full HD LED,50,42999,59990,Android,4.237685459940661,16991
483,LG ,Ultra HD LED,43,79990,79990,WebOS,4.4,0
484,LG ,Ultra HD LED,65,84990,129990,WebOS,4.237685459940661,45000
485,SAMSUNG,Ultra HD LED,55,229900,229900,Tizen,4.237685459940661,0
486,LLOYD ,HD LED,31,16485,22990,Linux,4.3,6505
487,TOSHIBA,Ultra HD LED,65,63999,119999,VIDAA,4.237685459940661,56000
488,LG ,Ultra HD LED,55,62490,79990,WebOS,4.0,17500
489,SAMSUNG,Ultra HD LED,55,67990,86900,Tizen,3.9,18910
490,POWER GUARD,Ultra HD LED,55,41999,58990,Android,4.237685459940661,16991
491,LG ,Full HD LED,43,39290,49990,WebOS,4.2,10700
492,T-SERIES,Full HD LED,43,26999,33990,Android,4.237685459940661,6991
493,AKAI ,Ultra HD LED,55,46345,59990,Android,4.237685459940661,13645
494,POWER GUARD,HD LED,32,13300,19990,Android,4.237685459940661,6690
495,POWER GUARD,Ultra HD LED,49,34900,54990,Android,4.237685459940661,20090
497,KODAK ,Ultra HD LED,49,47990,50999,Android,4.1,3009
499,POWER GUARD,QLED Ultra HD,50,51990,59990,Android,4.237685459940661,8000
500,JVC,Ultra HD LED,43,26990,52000,Android,4.3,25010
502,DYANORA,HD LED,40,15499,23999,Android,2.4,8500
503,SAMSUNG,Full HD LED,49,92500,92500,Tizen,4.1,0
504,POWER GUARD,QLED Ultra HD,55,69990,74990,Android,4.237685459940661,5000
505,JVC,Ultra HD LED,55,45000,69000,Android,3.9,24000
506,POWER GUARD,Ultra HD LED,65,55990,89990,Android,4.237685459940661,34000
507,HISENSE,QLED Ultra HD,75,499990,499990,Android,4.237685459940661,0
508,SONY ,Ultra HD LED,43,40999,61900,Android,4.6,20901
509,SAMSUNG,Full HD LED,43,31990,38900,Tizen,4.4,6910
510,SAMSUNG,Full HD LED,43,36890,45900,Tizen,4.7,9010
511,SAMSUNG,Full HD LED,43,39999,49900,Tizen,4.3,9901
512,IFFALCON BY TCL,Ultra HD LED,65,53499,156990,Android,4.3,103491
513,MI ,Ultra HD LED,55,47999,54999,Android,4.4,7000
514,SAMSUNG,Ultra HD LED,55,51999,72900,Tizen,4.5,20901
515,MOTOROLA,Ultra HD LED,50,34999,54050,Android,4.3,19051
516,TCL ,Ultra HD LED,55,38356,89990,Android,4.237685459940661,51634
517,TCL ,Ultra HD LED,43,29999,55990,Linux,4.1,25991
518,KODAK ,Full HD LED,40,15499,31990,Android,4.3,16491
519,SAMSUNG,Full HD LED,43,34999,58900,Tizen,4.5,23901
520,MICROMAX,HD LED,32,12990,25075,Android,4.0,12085
521,SONY ,Ultra HD LED,49,49999,104900,Android,4.5,54901
522,LG ,Ultra HD LED,43,36990,52990,WebOS,4.4,16000
523,SONY ,HD LED,32,14023,25900,Android,4.4,11877
524,THOMSON,Ultra HD LED,65,47999,79999,Android,4.4,32000
525,THOMSON,Full HD LED,43,17999,26999,Android,4.2,9000
526,SAMSUNG,Ultra HD LED,43,43751,77900,Tizen,4.4,34149
527,TCL ,Ultra HD LED,55,37319,51990,Linux,4.3,14671
528,LG ,Ultra HD LED,75,149990,269900,WebOS,4.237685459940661,119910
529,TOSHIBA,Ultra HD LED,55,40599,50999,VIDAA,4.3,10400
530,SAMSUNG,Ultra HD LED,43,36999,66900,Tizen,4.5,29901
531,PHILIPS,Ultra HD LED,65,78999,199990,Android,4.6,120991
532,VU,Ultra HD LED,55,29950,49990,Linux,4.4,20040
533,MICROMAX,Ultra HD LED,55,49999,69990,Android,4.2,19991
534,LG ,Ultra HD LED,43,37890,49990,WebOS,4.5,12100
535,SONY ,Ultra HD LED,49,60999,84900,Linux,4.5,23901
536,LG ,Ultra HD LED,55,84999,166990,WebOS,4.5,81991
537,SAMSUNG,Full HD LED,43,36514,46900,Tizen,4.5,10386
538,G-TEN ,HD LED,40,15990,35890,Android,3.7,19900
539,LG ,Ultra HD LED,49,47249,73990,WebOS,4.3,26741
541,TCL ,Ultra HD LED,43,27889,52990,Android,4.4,25101
542,SAMSUNG,HD LED,32,11999,21900,Tizen,4.4,9901
543,LG ,Ultra HD LED,65,102890,172990,WebOS,5.0,70100
544,IMPEX ,HD LED,39,19039,26350,HomeOS,4.237685459940661,7311
545,LG ,HD LED,28,13945,17990,Linux,4.4,4045
546,SONY ,Full HD LED,40,31999,37990,Android,4.3,5991
547,IFFALCON BY TCL,Ultra HD LED,55,31999,70990,Android,4.4,38991
548,SONY ,HD LED,32,20738,22990,Android,5.0,2252
549,TCL ,HD LED,32,15499,25990,Linux,4.1,10491
550,COMPAQ ,QLED Ultra HD,55,59999,99999,Android,4.4,40000
551,SAMSUNG,Full HD LED,43,36999,58900,Tizen,4.3,21901
552,PHILIPS,Full HD LED,43,24999,55990,Linux,4.0,30991
553,HAIER ,Full HD LED,40,25590,36990,Android,4.7,11400
554,SAMSUNG,Ultra HD LED,43,36106,69900,Tizen,4.3,33794
555,SAMSUNG,Full HD LED,43,24726,45900,Tizen,3.8,21174
556,TCL ,Ultra HD LED,43,25999,48990,Linux,4.1,22991
557,VU,Ultra HD LED,75,84999,130000,Linux,4.1,45001
558,SKYWORTH,HD LED,24,8659,12490,Unknown,3.0,3831
559,MASER ,HD LED,24,7499,7999,Unknown,3.8,500
560,IMPEX ,Full HD LED,43,36379,52990,HomeOS,4.0,16611
561,SAMSUNG,HD LED,32,15210,27900,Tizen,4.3,12690
562,TCL ,HD LED,24,7499,11990,HomeOS,4.0,4491
563,PHILIPS,Full HD LED,42,42000,42000,Android,3.8,0
564,MICROMAX,HD LED,32,14999,27990,Android,4.1,12991
565,SANYO ,Ultra HD LED,55,50999,76990,Linux,4.5,25991
566,SONY ,Ultra HD LED,55,134993,299900,Linux,4.237685459940661,164907
567,SONY ,HD LED,32,22999,27990,Linux,4.4,4991
568,MICROMAX,HD LED,20,6498,10590,Android,4.2,4092
569,SONY ,Ultra HD LED,55,82493,129900,Android,4.8,47407
570,LG ,HD LED,32,28311,30900,WebOS,3.7,2589
571,VU,HD LED,32,13999,19000,Android,4.3,5001
572,SONY ,Ultra HD LED,49,66104,129900,Android,4.4,63796
573,SAMSUNG,Ultra HD LED,43,35999,52900,Tizen,4.5,16901
574,PANASONIC,Full HD LED,43,36999,49900,Android,4.4,12901
575,LG ,Ultra HD LED,50,44990,66990,WebOS,4.4,22000
576,LG ,HD LED,24,14771,15900,Linux,4.4,1129
577,MICROMAX,HD LED,32,10499,19990,Android,4.3,9491
578,SAMSUNG,HD LED,32,17499,20900,Tizen,4.3,3401
579,VU,Full HD LED,40,16999,32175,Android,4.4,15176
580,SAMSUNG,Full HD LED,40,19929,43476,Tizen,4.3,23547
581,TCL ,QLED Ultra HD,75,149990,399990,Android,3.9,250000
582,IFFALCON BY TCL,Ultra HD LED,43,29999,76990,Android,4.3,46991
583,PANASONIC,Full HD LED,49,42999,72900,Linux,4.2,29901
584,VU,Full HD LED,43,22499,31000,Android,4.2,8501
585,MURPHY ,Full HD LED,32,12990,16990,Unknown,4.237685459940661,4000
586,HISENSE,QLED Ultra HD,65,84990,109990,Android,4.237685459940661,25000
587,CLOUDWALKER,Ultra HD LED,55,36999,61990,Android,4.1,24991
588,SONY ,Full HD LED,32,31990,39990,Linux,4.5,8000
589,SANYO ,Ultra HD LED,49,39999,64990,Linux,3.9,24991
590,PANASONIC,Full HD LED,43,27990,56900,Android,4.1,28910
591,VU,Ultra HD LED,50,37254,60000,Android,4.3,22746
592,LG ,Ultra HD LED,55,115658,212490,WebOS,4.6,96832
593,SONY ,Ultra HD LED,65,152999,269900,Android,4.5,116901
594,MICROMAX,Full HD LED,40,18990,36663,Android,4.2,17673
595,LG ,Full HD LED,22,13933,14500,Linux,4.6,567
596,LG ,HD LED,24,14495,14500,Linux,4.4,5
597,SONY ,Ultra HD LED,65,140791,209900,Android,4.8,69109
598,VU,Ultra HD LED,50,27999,55000,Android,4.4,27001
599,MI ,Ultra HD LED,55,43477,44999,Android,4.237685459940661,1522
600,TCL ,Full HD LED,40,19489,36419,Linux,4.1,16930
601,PANASONIC,Ultra HD LED,65,114999,179900,Linux,4.8,64901
602,LG ,Ultra HD LED,43,36999,55990,WebOS,4.5,18991
603,LG ,HD LED,32,19603,26490,Linux,4.4,6887
604,SAMSUNG,Full HD LED,50,36900,36900,Tizen,3.8,0
605,PHILIPS,Ultra HD LED,55,48999,89990,Android,4.0,40991
606,MICROMAX,HD LED,22,8900,10000,Android,4.2,1100
607,VU,Ultra HD LED,50,50000,50000,Android,4.4,0
608,MI ,Full HD LED,49,32994,32999,Android,4.4,5
609,INTEX ,HD LED,32,12699,27990,Android,3.6,15291
610,KODAK ,Full HD LED,49,22999,31990,Android,4.3,8991
611,PHILIPS,HD LED,32,10840,24990,Android,4.1,14150
612,ONIDA,Full HD LED,49,29990,50990,Android,4.4,21000
613,DEKTRON,HD LED,24,6999,10999,Linux,4.3,4000
614,RGL ,Full HD LED,21,5200,9420,HomeOS,3.9,4220
615,SONY ,Full HD LED,52,37900,37900,Linux,4.6,0
616,CLOUDWALKER,Full HD LED,43,17499,32990,Android,4.3,15491
617,LG ,HD LED,24,15552,16900,Linux,2.0,1348
618,TOSHIBA,Ultra HD LED,43,28999,38999,VIDAA,4.237685459940661,10000
619,LG ,Full HD LED,22,12453,13500,Linux,4.1,1047
620,IFFALCON BY TCL,HD LED,32,13990,18990,Android,4.2,5000
621,LG ,Full HD LED,32,32527,38900,WebOS,4.3,6373
622,SAMSUNG,Full HD LED,40,33000,43850,Tizen,3.8,10850
623,MICROMAX,HD LED,24,5792,11990,Android,4.3,6198
624,CLOUDWALKER,Ultra HD LED,55,84500,84500,Android,3.7,0
625,SAMSUNG,Full HD LED,32,20126,40900,Tizen,4.4,20774
626,SAMSUNG,Full HD LED,32,15990,34900,Tizen,4.2,18910
627,VU,HD LED,32,14999,15000,Android,4.3,1
628,LUMX ,HD LED,32,11990,23900,Android,4.237685459940661,11910
629,PANASONIC,Full HD LED,43,53999,59900,Android,4.4,5901
630,RGL ,Full HD LED,22,5490,9990,HomeOS,3.9,4500
631,LG ,Full HD LED,32,31990,31990,WebOS,4.4,0
632,CLOUDWALKER,HD LED,32,11999,19990,Android,4.3,7991
633,SHARP ,Ultra HD LED,50,37396,79990,Linux,4.237685459940661,42594
635,AKAI ,HD LED,32,17500,23190,Android,4.237685459940661,5690
636,SONY ,Full HD LED,50,52999,79900,Linux,4.5,26901
637,LG ,Full HD LED,43,25999,35990,WebOS,4.3,9991
639,ONIDA,Ultra HD LED,43,29800,49990,Android,4.1,20190
640,MOTOROLA,Ultra HD LED,55,39999,61600,Android,4.3,21601
641,VU,Ultra HD LED,43,23999,46165,Android,4.3,22166
642,CLOUDWALKER,Full HD LED,39,14999,26990,Android,4.2,11991
643,LG ,HD LED,32,20776,28990,WebOS,4.5,8214
644,CLOUDWALKER,HD LED,32,17989,17990,Android,4.3,1
645,CLOUDWALKER,Full HD LED,43,21999,31990,Android,4.0,9991
646,LG ,HD LED,24,6765,13490,Linux,4.3,6725
647,DETEL ,HD LED,32,7833,21999,Android,4.2,14166
648,VU,HD LED,32,10999,18000,Android,4.4,7001
649,CLOUDWALKER,Ultra HD LED,43,24999,37990,Android,3.9,12991
650,PANASONIC,HD LED,32,27399,27400,Android,4.4,1
651,PANASONIC,Ultra HD LED,49,62999,111900,Android,2.8,48901
652,PANASONIC,Ultra HD LED,55,90104,178900,Linux,4.237685459940661,88796
653,LG ,Full HD LED,43,24930,45674,Linux,4.0,20744
654,MICROMAX,HD LED,32,16825,23990,Android,4.3,7165
655,PANASONIC,Full HD LED,32,62900,62900,Android,4.237685459940661,0
656,KRISONS,HD LED,20,6599,7999,Android,4.237685459940661,1400
657,PANASONIC,Full HD LED,40,34639,39900,Android,4.1,5261
658,THOMSON,Ultra HD LED,43,24999,39999,Android,4.4,15000
659,WESTON ,Ultra HD LED,55,59990,59990,Android,4.2,0
660,SAMSUNG,HD LED,32,13990,28900,Tizen,4.5,14910
661,TCL ,Ultra HD LED,65,159990,159990,Android,4.237685459940661,0
662,PANASONIC,HD LED,32,26999,29900,Android,4.2,2901
663,CROMA ,HD LED,32,13994,20000,Android,3.6,6006
664,TCL ,Ultra HD LED,55,116990,116990,Android,4.237685459940661,0
665,BLAUPUNKT,Ultra HD LED,55,29199,60000,Android,3.8,30801
670,RGL ,Full HD LED,50,35990,39990,HomeOS,3.9,4000
671,SAMSUNG,Full HD LED,46,87500,87500,Tizen,3.7,0
672,AISEN  ,Ultra HD LED,55,63900,64900,Android,4.237685459940661,1000
673,PANASONIC,Ultra HD LED,55,168900,168900,Android,3.8,0
674,AISEN  ,Ultra HD LED,49,47900,48900,Android,4.237685459940661,1000
675,SAMSUNG,Ultra HD LED,55,178900,178900,Tizen,3.9,0
676,SAMSUNG,Full HD LED,46,145500,145500,Tizen,4.237685459940661,0
677,SAMSUNG,Full HD LED,60,210900,210900,Tizen,4.237685459940661,0
678,SAMSUNG,Full HD LED,55,160500,160500,Tizen,4.237685459940661,0
679,SAMSUNG,Full HD LED,46,139990,139990,Tizen,4.5,0
680,SAMSUNG,Full HD LED,55,189900,189900,Tizen,4.6,0
681,SAMSUNG,Full HD LED,55,267000,267000,Tizen,4.2,0
682,G-TEN ,Full HD LED,43,14990,38990,Android,3.5,24000
683,ONIDA,Full HD LED,43,28999,33990,Android,4.1,4991
684,SAMSUNG,Full HD LED,55,218900,218900,Tizen,4.237685459940661,0
685,SAMSUNG,Full HD LED,55,249990,249990,Tizen,4.3,0
686,LG ,Full HD LED,47,112000,112000,WebOS,5.0,0
687,SAMSUNG,HD Plasma,43,45000,45000,Tizen,4.0,0
688,SAMSUNG,Full HD LED,55,246900,246900,Tizen,4.237685459940661,0
689,LG ,Ultra HD LED,49,70556,84900,WebOS,4.237685459940661,14344
690,ONIDA,HD LED,32,14990,25000,Android,4.1,10010
691,LG ,Full HD LED,49,62743,71900,WebOS,4.237685459940661,9157
692,LG ,Ultra HD LED,55,131825,154900,WebOS,3.8,23075
693,LG ,Full HD LED,49,58988,66900,WebOS,4.0,7912
694,LG ,Full HD LED,47,105000,105000,WebOS,4.237685459940661,0
695,SAMSUNG,Ultra HD LED,55,178500,178500,Tizen,3.8,0
696,SAMSUNG,HD Plasma,49,68000,68000,Tizen,3.3,0
697,LG ,Ultra HD LED,49,95007,117900,WebOS,3.4,22893
698,PANASONIC,Full HD LED,40,49000,50000,Android,4.237685459940661,1000
699,LG ,Ultra HD LED,49,77277,103900,WebOS,4.3,26623
700,RGL ,Full HD LED,39,16490,29990,HomeOS,3.9,13500
701,LG ,Full HD LED,55,250000,250000,WebOS,4.237685459940661,0
702,LG ,Ultra HD LED,49,102325,119900,WebOS,4.237685459940661,17575
703,LG ,Full HD LED,49,67260,74900,WebOS,3.6,7640
704,LG ,Ultra HD LED,55,159589,189900,WebOS,3.9,30311
705,TCL ,Ultra HD LED,43,47990,47990,Android,3.7,0
706,LG ,HD Plasma,50,57990,57990,WebOS,4.237685459940661,0
707,PANASONIC,Full HD LED,43,30743,50900,Android,4.3,20157
708,LG ,Full HD LED,60,210000,210000,WebOS,4.4,0
709,SAMSUNG,HD LED,32,35700,35700,Tizen,3.3,0
716,IMPEX ,Full HD LED,43,54990,54990,Android,4.237685459940661,0
717,AISEN  ,Ultra HD LED,65,79990,99900,Android,4.237685459940661,19910
718,SAMSUNG,Full HD LED,65,385500,385500,Tizen,4.237685459940661,0
719,LG ,Ultra HD LED,55,142237,169900,WebOS,5.0,27663
720,SAMSUNG,Full HD LED,75,419900,419900,Tizen,4.237685459940661,0
721,ONIX ,Ultra HD LED,55,67990,67990,Android,4.237685459940661,0
722,G-TEN ,HD LED,40,12999,26350,Android,3.9,13351
723,LG ,Full HD LED,60,190000,190000,WebOS,4.8,0
724,SAMSUNG,HD LED,48,70500,70500,Tizen,4.0,0
725,TCL ,Ultra HD LED,55,74990,74990,Linux,4.3,0
726,COMPAQ ,Full HD LED,43,22999,29999,Android,4.2,7000
727,COMPAQ ,Ultra HD LED,50,32999,39999,Android,4.4,7000
728,COMPAQ ,HD LED,32,13999,15999,Android,4.2,2000
729,ACER,Ultra HD LED,55,39999,54990,Android,3.8,14991
731,ACER,Ultra HD LED,70,69999,99990,Android,4.3,29991
732,ACER,Ultra HD LED,43,34990,34990,Android,3.8,0
733,ADSUN,HD LED,39,13699,22999,Android,3.8,9300
734,ADSUN,Ultra HD LED,55,28499,54999,Android,3.8,26500
735,ADSUN,Ultra HD LED,50,23349,43999,Android,3.8,20650
736,ADSUN,HD LED,39,15699,21999,Android,3.8,6300
737,AISEN  ,Ultra HD LED,43,33950,34950,Android,4.237685459940661,1000
738,AISEN  ,HD LED,40,17990,24990,Android,3.3,7000
739,AISEN  ,HD LED,32,12990,13990,Android,4.237685459940661,1000
740,AISEN  ,Full HD LED,32,17990,31900,Android,4.237685459940661,13910
741,AISEN  ,HD LED,24,8990,9990,Android,4.237685459940661,1000
743,AKAI ,QLED Ultra HD,55,55947,99990,Android,4.237685459940661,44043
745,BLAUPUNKT,HD LED,32,7999,18000,Android,4.2,10001
746,BLAUPUNKT,HD LED,24,5999,11000,Android,4.1,5001
747,BLAUPUNKT,HD LED,32,9999,22000,Android,4.1,12001
748,BLAUPUNKT,Ultra HD LED,49,25999,45000,Android,4.0,19001
749,BLAUPUNKT,Full HD LED,43,15999,32000,Android,4.2,16001
750,BLAUPUNKT,Full HD LED,40,15999,28000,Android,4.1,12001
751,BLAUPUNKT,Ultra HD LED,43,21999,40000,Android,3.9,18001
752,BLAUPUNKT,Ultra HD LED,49,28999,55000,Android,4.1,26001
753,COOCAA ,Ultra HD LED,50,28990,53990,Android,4.1,25000
754,COOCAA ,Ultra HD LED,50,25999,59990,Android,4.3,33991
755,COOCAA ,Ultra HD LED,55,31999,69999,Android,4.3,38000
756,DEKTRON,HD LED,19,5499,8999,Linux,4.237685459940661,3500
757,DEKTRON,HD LED,22,6999,10999,Linux,4.237685459940661,4000
758,DEKTRON,HD LED,20,7399,9999,Linux,4.237685459940661,2600
759,DETEL ,HD LED,32,11300,23999,Android,3.9,12699
760,G-TEN ,Full HD LED,43,16490,47990,Android,3.8,31500
761,G-TEN ,HD LED,32,9990,17990,Android,4.3,8000
762,G-TEN ,Ultra HD LED,50,22499,58890,Android,3.7,36391
763,G-TEN ,Ultra HD LED,55,29399,65990,Android,3.9,36591
764,G-TEN ,HD LED,32,12990,19990,Android,3.8,7000
765,HAIER ,Full HD LED,42,30999,44990,Android,5.0,13991
766,HAIER ,Full HD LED,43,30990,38642,Android,4.5,7652
767,HAIER ,Ultra HD LED,50,38590,54990,Android,4.3,16400
768,HAIER ,HD LED,32,21599,25990,Android,4.0,4391
769,HAIER ,Ultra HD LED,55,54499,89990,Android,4.6,35491
770,HAIER ,Ultra HD LED,50,42000,69990,Android,4.0,27990
771,HAIER ,Ultra HD LED,55,47899,77990,Android,4.237685459940661,30091
772,HAIER ,HD LED,39,15990,31999,Android,4.3,16009
773,HAIER ,HD LED,32,7739,19990,Android,4.0,12251
774,HUIDI ,HD LED,32,9499,16599,Android,4.0,7100
775,HUIDI ,Ultra HD LED,49,26999,36999,Android,4.5,10000
776,HUIDI ,Ultra HD LED,55,36999,46999,Android,4.237685459940661,10000
777,IFFALCON BY TCL,Ultra HD LED,50,28999,58990,Android,4.3,29991
778,IFFALCON BY TCL,Ultra HD LED,55,113990,113990,Android,4.237685459940661,0
779,IFFALCON BY TCL,Ultra HD LED,65,49999,99990,Android,4.237685459940661,49991
780,IMPEX ,HD LED,32,9999,16990,HomeOS,3.6,6991
781,IMPEX ,HD LED,32,11390,18190,HomeOS,4.7,6800
782,IMPEX ,HD LED,24,7999,12990,HomeOS,4.4,4991
783,IMPEX ,Ultra HD LED,55,60859,89990,Android,4.237685459940661,29131
784,IMPEX ,Full HD LED,50,31000,49990,Android,4.237685459940661,18990
785,INTEX ,HD LED,38,19800,34600,Android,5.0,14800
786,INTEX ,Full HD LED,55,49900,49900,Android,4.3,0
787,INTEX ,Full HD LED,50,29499,39999,Android,3.8,10500
788,INTEX ,Full HD LED,43,23688,47990,Android,4.2,24302
789,INTEX ,Full HD LED,43,35999,35999,Android,4.2,0
790,JVC,Ultra HD LED,65,55000,109000,Android,4.1,54000
791,JVC,HD LED,32,16990,21000,Android,4.1,4010
792,JVC,HD LED,24,12999,12999,Android,3.8,0
793,KRISONS,HD LED,19,5499,7999,Android,4.237685459940661,2500
794,KRISONS,HD LED,17,5499,6999,Android,4.237685459940661,1500
798,LLOYD ,Full HD LED,39,22990,39990,Linux,3.8,17000
799,LLOYD ,Full HD LED,48,39999,50990,Linux,4.237685459940661,10991
800,LLOYD ,Ultra HD LED,43,33999,69990,Linux,4.2,35991
801,LLOYD ,HD LED,32,14990,19990,Linux,4.3,5000
802,LLOYD ,Ultra HD LED,42,25990,59900,Linux,3.5,33910
803,LLOYD ,Full HD LED,55,114990,114990,Linux,4.237685459940661,0
804,LLOYD ,Full HD LED,46,55990,55990,Linux,5.0,0
805,LLOYD ,HD LED,32,11000,20990,Linux,3.7,9990
806,LLOYD ,HD LED,24,8103,15990,Linux,3.7,7887
807,LLOYD ,Ultra HD LED,55,51999,99990,Linux,3.7,47991
808,LLOYD ,HD LED,24,13200,14990,Linux,2.5,1790
809,LLOYD ,Full HD LED,43,25490,39000,Linux,4.237685459940661,13510
810,LUMX ,HD LED,24,7290,17900,Android,4.3,10610
811,LUMX ,HD LED,40,29990,29990,Android,4.237685459940661,0
812,LUMX ,Ultra HD LED,55,65900,65900,Android,4.237685459940661,0
813,MARQ BY FLIPKART,HD LED,24,7499,14999,Unknown,4.2,7500
814,MARQ BY FLIPKART,Full HD LED,24,6999,11499,Unknown,4.3,4500
815,MARQ BY FLIPKART,Full HD LED,32,9499,16499,Unknown,4.3,7000
816,MARQ BY FLIPKART,HD LED,32,13499,15499,Android,4.1,2000
817,MARQ BY FLIPKART,Full HD LED,40,18999,29499,Linux,4.3,10500
818,MARQ BY FLIPKART,HD LED,32,10499,18499,Linux,4.3,8000
819,MICROMAX,Ultra HD LED,43,91990,91990,Android,4.0,0
820,MICROMAX,Full HD LED,40,29990,29990,Android,4.0,0
821,MICROMAX,Full HD LED,49,65990,65990,Android,4.4,0
822,MICROMAX,Full HD LED,50,66990,66990,Android,4.3,0
823,MICROMAX,Full HD LED,55,71990,71990,Android,4.2,0
824,MICROMAX,HD LED,24,11999,13490,Android,3.9,1491
825,MICROMAX,Full HD LED,24,6179,13390,Android,4.2,7211
826,MICROMAX,HD LED,20,5364,10990,Android,4.1,5626
827,MOTOROLA,Ultra HD LED,55,42999,61999,Android,4.4,19000
828,MURPHY ,Full HD LED,32,13990,14999,Unknown,3.7,1009
829,MURPHY ,HD LED,24,7490,12990,Unknown,3.0,5500
830,MURPHY ,Full HD LED,32,16799,17999,Android,2.6,1200
831,ONEPLUS,Ultra HD LED,50,43999,49999,Android,4.3,6000
832,ONEPLUS,QLED Ultra HD,55,84990,99900,Android,4.8,14910
833,ONEPLUS,Ultra HD LED,65,66999,69999,Android,4.3,3000
834,ONEPLUS,QLED Ultra HD,55,62899,69900,Android,4.6,7001
835,ONIDA,HD LED,24,8359,13490,Android,4.2,5131
836,ONIDA,HD LED,32,22990,22990,Android,4.7,0
837,ONIDA,Ultra HD LED,43,33190,52900,Android,4.2,19710
838,ONIDA,Full HD LED,32,56990,56990,Android,5.0,0
839,ONIDA,Full HD LED,32,35990,35990,Android,4.7,0
840,ONIX ,HD LED,32,19790,19790,Android,4.237685459940661,0
841,ONIX ,HD LED,39,14990,26349,Android,3.7,11359
842,ONIX ,Full HD LED,39,35990,35990,Android,4.237685459940661,0
843,OXYGEN ,Ultra HD LED,65,56990,124990,Android,4.237685459940661,68000
844,OXYGEN ,Ultra HD LED,43,27999,42990,Android,4.237685459940661,14991
845,PANASONIC,Ultra HD LED,43,30001,79900,HomeOS,4.3,49899
846,PANASONIC,Ultra HD LED,49,43259,66900,HomeOS,4.237685459940661,23641
847,PANASONIC,Ultra HD LED,55,55890,82400,HomeOS,4.237685459940661,26510
848,PHILIPS,Full HD LED,43,28999,35990,Linux,4.0,6991
849,PHILIPS,HD LED,32,18999,20990,Linux,4.0,1991
850,PHILIPS,Full HD LED,43,33459,36990,Android,4.5,3531
851,PHILIPS,Full HD LED,22,6649,12990,Unknown,3.9,6341
852,POWER GUARD,HD LED,24,10990,12990,HomeOS,4.237685459940661,2000
853,POWER GUARD,HD LED,24,11999,14990,Android,4.237685459940661,2991
854,POWER GUARD,HD LED,32,13300,19990,HomeOS,4.237685459940661,6690
855,POWER GUARD,HD LED,32,15650,28990,Android,4.237685459940661,13340
856,REALME ,HD LED,32,11999,21999,Linux,4.3,10000
857,REALME ,Ultra HD LED,55,46999,69999,Android,4.3,23000
858,RGL ,Full HD LED,20,4849,8990,HomeOS,3.9,4141
860,RGL ,Full HD LED,24,5459,12000,HomeOS,3.9,6541
861,RGL ,HD LED,32,11290,16990,HomeOS,3.7,5700
862,WESTON ,Full HD LED,40,27990,27990,Android,4.4,0
863,WESTON ,Full HD LED,43,37990,37990,Android,3.9,0
864,WESTON ,Ultra HD LED,43,40990,40990,Android,4.3,0
865,WESTON ,Full HD LED,49,49990,49990,Android,4.4,0
866,VU,Ultra HD LED,65,116000,116000,Linux,4.5,0
867,VU,Full HD LED,40,16999,27000,Linux,4.4,10001
868,VU,Ultra HD LED,43,23999,46165,Linux,4.3,22166
869,VU,Ultra HD LED,50,26360,41990,Linux,4.4,15630
870,VG ,HD LED,32,15990,20500,Android,4.237685459940661,4510
871,VG ,HD LED,39,17999,31000,Android,4.237685459940661,13001
872,T-SERIES,HD LED,32,12499,17990,Linux,4.237685459940661,5491
873,T-SERIES,HD LED,32,16499,18990,Android,3.9,2491
874,T-SERIES,HD LED,32,15999,20990,Android,4.237685459940661,4991
875,T-SERIES,Full HD LED,40,18499,25990,Android,4.237685459940661,7491
876,TOSHIBA,Full HD LED,43,24999,31990,VIDAA,4.237685459940661,6991
877,TOSHIBA,Ultra HD LED,65,66999,84990,VIDAA,4.5,17991
878,TOSHIBA,Full HD LED,49,29999,51999,VIDAA,4.237685459940661,22000
879,TOSHIBA,Ultra HD LED,65,96999,133990,VIDAA,4.237685459940661,36991
880,TCL ,HD LED,32,6166,19990,HomeOS,4.2,13824
881,TCL ,HD LED,24,6940,15490,HomeOS,4.2,8550
882,TCL ,HD LED,40,8679,29990,HomeOS,4.0,21311
883,SHARP ,Full HD LED,60,229900,229900,Linux,4.237685459940661,0
884,SHARP ,Full HD LED,46,151990,151990,Linux,4.237685459940661,0
885,SHARP ,Full HD LED,70,449900,449900,Linux,4.237685459940661,0
886,SHARP ,Full HD LED,52,199990,199990,Linux,4.237685459940661,0
887,SHARP ,Full HD LED,40,103990,103990,Linux,4.237685459940661,0
888,SHARP ,HD LED,32,15990,22500,Linux,3.0,6510
889,SHARP ,HD LED,24,8220,14990,Linux,3.7,6770
890,SANSUI ,Ultra HD LED,43,30490,35350,Linux,4.1,4860
891,SANSUI ,Ultra HD LED,55,40999,53290,Linux,4.2,12291
893,SANSUI ,QLED Ultra HD,55,49900,72590,Linux,4.3,22690
894,SANSUI ,Ultra HD LED,65,47999,70290,Linux,4.1,22291
895,SANSUI ,Full HD LED,49,25999,49999,Android,4.3,24000
896,SANSUI ,Ultra HD LED,49,59990,59990,Linux,4.237685459940661,0
897,SANSUI ,HD LED,24,10500,14900,Android,4.237685459940661,4400
898,SONY ,Ultra HD LED,55,79290,109900,Linux,4.7,30610
900,SONY ,Ultra HD LED,65,118641,183249,Linux,4.7,64608
901,SONY ,Ultra HD LED,50,83491,99913,Linux,4.7,16422
902,SONY ,Full HD LED,43,53423,53423,Linux,4.4,0
903,SONY ,Full HD LED,40,29999,49900,Linux,4.4,19901
904,SONY ,HD LED,32,25990,31990,Linux,4.4,6000
905,SONY ,Full HD LED,32,21223,33900,Linux,4.5,12677
906,SONY ,Ultra HD LED,49,54999,114900,Linux,4.6,59901
907,SONY ,Full HD LED,43,44999,57900,Linux,4.4,12901
908,SONY ,Full HD LED,40,41499,51900,Linux,4.6,10401
909,SONY ,Ultra HD LED,65,149990,184990,Linux,4.3,35000
910,SONY ,HD LED,32,32900,32900,Linux,4.4,0
911,SONY ,Full HD LED,43,56900,56900,Linux,4.6,0
